X X X X X X X X X X X X X X X X X X X X X X X X X X X X X X X X X X X X X X X X X X X X X
X X X X X X X X X X X X X X X X X X X X X X X X X X X X X X X X X X X X X X X X X X X X X
X X X X X X X X X X X X X X X X X X X X X X X X X X X X X X X X X X X X X X X X X X X X X
X X X X X X X X X X X X X X X X X X X X X X X X X X X X X X X X X X X X X X X X X X X X X
X X X X X X X X X X X X X X X X X X X X X X X X X X X X X X X X X X X X X X X X X X X X X
X 1 0 0 0 0 0 0 0 0 0 0 0 0 0 0 0 0 0 0 0 0 0 0 0 0 0 0 0 0 0 0 0 0 0 0 0 0 0 0 0 0 0 0 0
X 1 + . . p . + . . . . . . . p . . . . + . . . . + . . . . . . . . . . . . + . p . . + 3
X 1 0 0 0 0 0 0 0 0 0 0 0 0 0 0 0 0 0 X . 0 0 0 0 . X 0 0 0 0 0 0 0 0 0 0 0 0 0 0 0 0 0 3
X 1 0 0 0 0 0 0 0 0 0 0 0 0 0 0 0 0 0 X . 0 0 0 0 . X 0 0 0 0 0 0 0 0 0 0 0 0 0 0 0 0 0 3
X 1 + . . . . + X 0 0 0 0 0 0 0 0 0 0 X . 0 0 0 0 . X 0 0 0 0 0 0 0 0 0 0 X + . . . . + 3
X 1 . 0 0 0 0 . X 0 0 0 0 0 0 0 0 0 0 X . 0 0 0 0 . X 0 0 0 0 0 0 0 0 0 0 X . 0 0 0 0 . 3
X 1 . 0 0 0 0 . X 0 0 0 0 0 0 0 0 0 0 X . 0 0 0 0 . X 0 0 0 0 0 0 0 0 0 0 X . 0 0 0 0 . 3
X 1 . 0 0 0 0 . X 0 0 0 0 0 0 0 0 0 0 X . 0 0 0 0 . X 0 0 0 0 0 0 0 0 0 0 X . 0 0 0 0 . 3
X 1 . 0 0 0 0 p X 0 0 0 0 0 0 0 0 0 0 X . 0 0 0 0 . X 0 0 0 0 0 0 0 0 0 0 X . 0 0 0 0 . 3
X 1 . 0 0 0 0 . X 0 0 0 0 0 0 0 0 0 0 X . 0 0 0 0 . X 0 0 0 0 0 0 0 0 0 0 X . 0 0 0 0 . 3
X 1 . 0 0 0 0 . X 0 0 0 0 0 0 0 0 0 0 X . 0 0 0 0 . X 0 0 0 0 0 0 0 0 0 0 X . 0 0 0 0 . 3
X 1 . 0 0 0 0 . X 0 0 0 0 0 0 0 0 0 0 X . 0 0 0 0 . X 0 0 0 0 0 0 0 0 0 0 X . 0 0 0 0 I 3
X 1 . 0 0 0 0 . X 0 0 0 0 0 0 0 0 0 0 X . 0 0 0 0 . X 0 0 0 0 0 0 0 0 0 0 X . 0 0 0 0 . 3
X 1 . 0 0 0 0 . X 0 0 0 0 0 0 0 0 0 0 X . 0 0 0 0 . X 0 0 0 0 0 0 0 0 0 0 X . 0 0 0 0 . 3
X 1 + . . . . + . . . . . . E . . . . . + . . + . + . . . . . . . . . . . . + . . . . . 3
X 1 . 0 0 0 0 . 0 0 0 0 0 0 0 0 0 0 0 0 0 0 0 . 0 0 0 0 0 0 0 0 0 0 0 0 0 0 . 0 0 0 0 . 3
X 1 . 0 0 0 0 . 0 0 0 0 0 0 0 0 0 0 0 0 0 0 0 . 0 0 0 0 0 0 0 0 0 0 0 0 0 0 . 0 0 0 0 . 3
X 1 . 0 0 0 0 . 0 0 0 0 0 0 0 0 0 0 0 0 0 0 0 . 0 0 0 0 0 0 0 0 0 0 0 0 0 0 . 0 0 0 0 . 3
X 1 . 0 0 0 0 . 0 0 0 0 0 0 0 0 0 0 0 0 0 0 0 . 0 0 0 0 0 0 0 0 0 0 0 0 0 0 . 0 0 0 0 . 3
X 1 . 0 0 0 0 . 0 0 0 0 0 0 0 0 0 0 0 0 0 0 0 . 0 0 0 0 0 0 0 0 0 0 0 0 0 0 . 0 0 0 0 . 3
X 1 . 0 0 0 0 . 0 0 0 0 0 0 0 0 0 0 0 0 0 0 0 . 0 0 0 0 0 0 0 0 0 0 0 0 0 0 . 0 0 0 0 . 3
X 1 . 0 0 0 0 . 0 0 0 0 0 0 0 0 0 0 0 0 0 0 0 . 0 0 0 0 0 0 0 0 0 0 0 0 0 0 . 0 0 0 0 . 3
X 1 . 0 0 0 0 . 0 0 0 0 0 0 0 0 0 0 0 0 0 0 0 . 0 0 0 0 0 0 0 0 0 0 0 0 0 0 . 0 0 0 0 . 3
X 1 . 0 0 0 0 . 0 0 0 0 0 0 0 0 0 0 0 0 0 0 0 . 0 0 0 0 0 0 0 0 0 0 0 0 0 0 . 0 0 0 0 . 3
X 1 . 0 0 0 0 . 0 0 0 0 0 0 0 0 0 0 0 0 0 0 0 . 0 0 0 0 0 0 0 0 0 0 0 0 0 0 . 0 0 0 0 . 3
X 1 . 0 0 0 0 . 0 0 0 0 0 0 0 0 0 0 0 0 0 0 0 . 0 0 0 0 0 0 0 0 0 0 0 0 0 0 . 0 0 0 0 . 3
X 1 + . . . . + . . . . . . . . . . . . . . . + . . . . . . . . . . . . . . + . . . . + 3
X 2 2 2 2 2 2 2 2 2 2 2 2 2 2 2 2 2 2 2 2 2 2 2 2 2 2 2 2 2 2 2 2 2 2 2 2 2 2 2 2 2 2 2 3
X X X X X X X X X X X X X X X X X X X X X X X X X X X X X X X X X X X X X X X X X X X X X