X X X X X X X X X X X X X X X X X X X X X X X X X X X X X X X X X X X X X X X X X X X X X
X X X X X X X X X X X X X X X X X X X X X X X X X X X X X X X X X X X X X X X X X X X X X
X X X X X X X X X X X X X X X X X X X X X X X X X X X X X X X X X X X X X X X X X X X X X
X X X X X X X X X X X X X X X X X X X X X X X X X X X X X X X X X X X X X X X X X X X X X
X X X X X X X X X X X X X X X X X X X X X X X X X X X X X X X X X X X X X X X X X X X X X
X 0 1 1 1 1 1 1 1 1 1 1 1 1 1 1 1 1 1 1 1 1 1 1 1 1 1 1 1 1 1 1 1 1 1 1 1 1 1 1 1 1 1 1 0
X 1 + . . . . + . . . . . . . . . . . . + . . . . + . . . . . . . . . . . . . . . . p + 1
X 1 . 4 4 4 4 . X 4 4 4 4 4 4 4 4 4 4 X . 4 4 4 4 . X 4 4 4 4 4 4 4 4 4 4 4 4 4 4 4 4 . 1
X 1 . 4 4 4 4 . X 4 4 4 4 4 4 4 4 4 4 X . 4 4 4 4 . X 4 4 4 4 4 4 4 4 4 4 4 4 4 4 4 4 . 1
X 1 . 4 4 4 4 p X 4 4 4 4 4 4 4 4 4 4 X + 4 4 4 4 . X 4 4 4 4 4 4 4 4 4 4 4 4 4 4 4 4 . 1
X 1 . 4 4 4 4 . X 4 4 4 4 4 4 4 4 4 4 X . 4 4 4 4 . X 4 4 4 4 4 4 4 4 4 4 4 4 4 4 4 4 . 1
X 1 . 4 4 4 4 . X 4 4 4 4 4 4 4 4 4 4 X . 4 4 4 4 . X 4 4 4 4 4 4 4 4 4 4 4 4 4 4 4 4 . 1
X 1 . 4 4 4 4 . X 4 4 4 4 4 4 4 4 4 4 X . 4 4 4 4 . X X X X X X X X X X X 4 4 4 4 4 4 . 1
X 1 . 4 4 4 4 . X 4 4 4 4 4 4 4 4 4 4 X . 4 4 4 4 + . . . . . . . . . p + 4 4 4 4 4 4 . 1
X 1 . 4 4 4 4 . X 4 4 4 4 4 4 4 4 4 4 X . 4 4 4 4 . X 4 4 4 4 4 4 4 4 4 4 4 4 4 4 4 4 . 1
X 1 . 4 4 4 4 . X 4 4 4 4 4 4 4 4 4 4 X . 4 4 4 4 . X 4 4 4 4 4 4 4 4 4 4 4 4 4 4 4 4 . 1
X 1 . 4 4 4 4 . X 4 4 4 4 4 4 4 4 4 4 X . 4 4 4 4 . X 4 4 4 4 4 4 4 4 4 4 4 4 4 4 4 4 I 1
X 1 . 4 4 4 4 . X 4 4 4 4 4 4 4 4 4 4 X . 4 4 4 4 . X 4 4 4 4 4 4 4 4 4 4 4 4 4 4 4 4 . 1
X 1 . X X X X . X X X X X X X X X X X X . X X X X . X X X X X X X X X X X X X X X X X . 1
X 1 + . . . . + . . . . . . . . + . . + + . . + . + . . . . . . . . . . . . + . . . . + 1
X 1 . 4 4 4 4 4 4 4 4 4 4 4 4 4 4 4 X . 4 4 X . 4 4 4 4 4 4 4 4 4 4 4 4 4 X . 4 4 4 4 . 1
X 1 . 4 4 4 4 4 4 4 4 4 4 4 4 4 4 4 X . 4 4 X . 4 4 4 4 4 4 4 4 4 4 4 4 4 X . 4 4 4 4 . 1
X 1 . 4 4 4 4 4 4 4 4 4 4 4 4 4 4 4 X . 4 4 X . 4 4 4 4 4 4 4 4 4 4 4 4 4 X . 4 4 4 4 . 1
X 1 . 4 4 4 4 4 4 4 4 4 4 4 4 4 4 4 X . 4 4 X . 4 4 4 4 4 4 4 4 4 4 4 4 4 X . 4 4 4 4 . 1
X 1 . 4 4 4 4 4 4 4 4 4 4 4 4 4 4 4 X . 4 4 X . 4 4 4 4 4 4 4 4 4 4 4 4 4 X . 4 4 4 4 . 1
X 1 . 4 4 4 X X X X X X X X X X X X X . 4 4 X . 4 4 4 4 4 4 4 4 4 4 4 4 4 X . 4 4 4 4 . 1
X 1 . 4 4 4 X + . . . . . . . . . . . + 4 4 X . 4 4 4 4 4 4 4 4 4 4 4 4 4 X + 4 4 4 4 . 1
X 1 . 4 4 4 X . 4 4 4 4 4 4 4 4 4 4 4 4 4 4 X . 4 4 4 4 4 4 4 4 4 4 4 4 4 X . 4 4 4 4 . 1
X 1 . 4 4 4 X . 4 4 4 4 4 4 4 4 4 4 4 4 4 4 X . 4 4 4 4 4 4 4 4 4 4 4 4 4 X . 4 4 4 4 . 1
X 1 . 4 4 4 X . 4 4 4 4 4 4 4 4 4 4 4 4 4 4 X . 4 4 4 4 4 4 4 4 4 4 4 4 4 X . 4 4 4 4 . 1
X 1 . 4 4 4 X . 4 4 4 4 4 4 4 4 4 4 4 4 4 4 X . 4 4 4 4 4 4 4 4 4 4 4 4 4 X . 4 4 4 4 . 1
X 1 + . . . . + . . . . . . . . . . . . . . . + . . . . . . . . . . . . . . p . . . . + 1
X 0 1 1 1 1 1 1 1 1 1 1 1 1 1 1 1 1 1 1 1 1 1 1 1 1 1 1 1 1 1 1 1 1 1 1 1 1 1 1 1 1 1 1 0
X X X X X X X X X X X X X X X X X X X X X X X X X X X X X X X X X X X X X X X X X X X X X